rapide	rapide
hermann	hermann
donita	donita
nad	nad
amiko	amiko
ludas	ludas
juan	juan
reto	reto
ligo	ligo
vivo	vivo
joseph	joseph
iris	iris
astronomo	astronomo
karaktero	karaktero
alta	alta
new	new
reprezentis	reprezentis
origino	origino
deklaro	deklaro
auguste	auguste
stelo	stelo
das	das
blue	blue
simpla	simpla
den	den
love	love
berlin	berlin
figuro	figuro
super	super
fino	fino
kreado	kreado
julio	julio
respondo	respondo
kapo	kapo
necesa	necesa
no	no
ekonomio	ekonomio
nun	nun
sola	sola
angla	angla
herbert	herbert
viktor	viktor
agnoskis	agnoskis
nune	nune
santo	santo
france	france
vizitis	vizitis
vino	vino
filmo	filmo
anthony	anthony
maurice	maurice
for	for
fondinto	fondinto
korea	korea
william	william
merkato	merkato
nombro	nombro
edukado	edukado
scott	scott
profunda	profunda
rené	rené
liberala	liberala
matematiko	matematiko
provizora	provizora
paro	paro
senato	senato
granda	granda
parte	parte
proceso	proceso
supra	supra
marto	marto
intereso	intereso
bin	bin
maría	maría
kompleta	kompleta
en	en
metodo	metodo
frazo	frazo
andrew	andrew
rezulto	rezulto
proklamis	proklamis
zono	zono
komence	komence
grandega	grandega
pedro	pedro
nuntempa	nuntempa
dividita	dividita
falis	falis
instituto	instituto
indikas	indikas
novembro	novembro
enfluas	enfluas
katedralo	katedralo
york	york
ora	ora
kazo	kazo
energio	energio
stilo	stilo
vizitas	vizitas
rudolf	rudolf
hugo	hugo
alfred	alfred
dinastio	dinastio
krizo	krizo
atingis	atingis
plus	plus
apartenas	apartenas
pacifiko	pacifiko
listo	listo
ekonomikisto	ekonomikisto
por	por
origine	origine
sen	sen
ofico	ofico
sudo	sudo
arto	arto
asteroido	asteroido
partoprenis	partoprenis
fratino	fratino
from	from
katolika	katolika
surfaco	surfaco
lee	lee
pro	pro
andreas	andreas
jacques	jacques
totala	totala
kristo	kristo
rio	rio
skribis	skribis
manko	manko
kompare	kompare
inventisto	inventisto
skribas	skribas
sultano	sultano
radiko	radiko
maniero	maniero
transporto	transporto
antonio	antonio
serio	serio
armeo	armeo
slava	slava
tipo	tipo
vidas	vidas
nicolas	nicolas
traktato	traktato
liberigo	liberigo
verko	verko
vasta	vasta
de	de
bob	bob
konduto	konduto
publikigita	publikigita
muzikisto	muzikisto
revuo	revuo
fluas	fluas
giovanni	giovanni
dio	dio
ludi	ludi
divido	divido
kapitano	kapitano
formulo	formulo
skota	skota
skalo	skalo
mi	mi
il	il
brian	brian
kilometro	kilometro
publika	publika
fenomeno	fenomeno
instrumento	instrumento
privata	privata
park	park
roman	roman
eniras	eniras
pasis	pasis
trovita	trovita
korpo	korpo
romano	romano
influis	influis
intensa	intensa
maso	maso
gastigas	gastigas
national	national
mortigis	mortigis
altitudo	altitudo
distrikto	distrikto
turismo	turismo
placo	placo
fondis	fondis
familio	familio
simon	simon
teatro	teatro
lernis	lernis
edward	edward
grande	grande
kg	kg
daniel	daniel
moderna	moderna
walter	walter
ol	ol
organizo	organizo
demokratio	demokratio
ex	ex
trono	trono
matematikisto	matematikisto
johnson	johnson
marso	marso
periodo	periodo
arkitekturo	arkitekturo
patro	patro
povos	povos
eklezio	eklezio
premio	premio
okupis	okupis
el	el
ernst	ernst
gitaristo	gitaristo
kulturo	kulturo
papo	papo
dek	dek
kuba	kuba
raso	raso
kreita	kreita
kanada	kanada
ekonomiko	ekonomiko
tri	tri
nek	nek
ja	ja
university	university
koncepto	koncepto
februaro	februaro
esperanto	esperanto
artisto	artisto
forta	forta
vorto	vorto
devis	devis
kredas	kredas
atmosfero	atmosfero
kristana	kristana
nacional	nacional
sorto	sorto
kompanio	kompanio
anne	anne
normala	normala
jack	jack
monumento	monumento
christian	christian
wilhelm	wilhelm
civila	civila
franklin	franklin
simila	simila
stephen	stephen
oktobro	oktobro
ukraina	ukraina
teritorio	teritorio
varma	varma
aktoro	aktoro
james	james
formi	formi
mortas	mortas
honore	honore
helpo	helpo
komitato	komitato
komuna	komuna
problemo	problemo
servis	servis
american	american
kongo	kongo
konsilantaro	konsilantaro
komenco	komenco
marie	marie
bill	bill
muziko	muziko
demokrata	demokrata
vivas	vivas
rolo	rolo
episkopo	episkopo
fc	fc
frua	frua
west	west
kune	kune
politikisto	politikisto
ke	ke
ligas	ligas
grupo	grupo
industrio	industrio
bulgara	bulgara
bronza	bronza
nova	nova
nome	nome
blua	blua
félix	félix
decidas	decidas
rusa	rusa
castro	castro
young	young
kantisto	kantisto
doktrino	doktrino
rezultis	rezultis
domingo	domingo
epoko	epoko
senco	senco
richard	richard
elekti	elekti
parko	parko
gramatiko	gramatiko
parolas	parolas
tute	tute
pianisto	pianisto
iras	iras
falo	falo
insulo	insulo
kaptis	kaptis
baseno	baseno
du	du
gabriel	gabriel
rezisto	rezisto
spaco	spaco
iberia	iberia
povus	povus
trans	trans
nivelo	nivelo
numero	numero
urbestro	urbestro
polico	polico
un	un
aktorino	aktorino
norda	norda
rakonto	rakonto
naskis	naskis
amerika	amerika
montaro	montaro
ido	ido
uzata	uzata
josef	josef
universala	universala
prenas	prenas
islamo	islamo
paul	paul
eric	eric
aparte	aparte
kiel	kiel
hitler	hitler
kariero	kariero
fiziko	fiziko
ali	ali
aŭ	aŭ
jackson	jackson
apartenis	apartenis
temperaturo	temperaturo
grand	grand
homo	homo
kontinento	kontinento
materio	materio
longa	longa
franca	franca
havis	havis
johannes	johannes
irlando	irlando
kreinto	kreinto
john	john
jan	jan
silva	silva
fondo	fondo
komencis	komencis
nederlando	nederlando
skolo	skolo
inter	inter
regiono	regiono
fronto	fronto
dei	dei
konsideras	konsideras
perdis	perdis
centre	centre
christopher	christopher
produktis	produktis
reprezentas	reprezentas
cm	cm
norde	norde
termino	termino
santa	santa
samtempe	samtempe
speco	speco
andré	andré
da	da
são	são
heinrich	heinrich
konsiderata	konsiderata
oceano	oceano
vintro	vintro
meze	meze
mortis	mortis
pri	pri
tro	tro
evento	evento
okupita	okupita
supera	supera
mario	mario
logiko	logiko
theodor	theodor
koloro	koloro
profesoro	profesoro
klubo	klubo
jorge	jorge
sur	sur
produktita	produktita
frank	frank
von	von
gaso	gaso
imperiestro	imperiestro
union	union
teorio	teorio
loko	loko
belga	belga
parolata	parolata
satelito	satelito
homaro	homaro
fina	fina
muhammad	muhammad
individuo	individuo
mitologio	mitologio
le	le
finis	finis
sporta	sporta
decido	decido
simbolo	simbolo
kreskas	kreskas
plu	plu
nomi	nomi
philippe	philippe
kreskis	kreskis
principo	principo
south	south
und	und
van	van
originale	originale
generalo	generalo
advokato	advokato
garcía	garcía
uzas	uzas
uzado	uzado
verki	verki
arthur	arthur
libro	libro
komerco	komerco
joe	joe
bona	bona
meza	meza
uzita	uzita
bezonas	bezonas
ramón	ramón
ad	ad
mediteraneo	mediteraneo
rango	rango
kreas	kreas
at	at
sendis	sendis
persono	persono
tempo	tempo
kelke	kelke
ludo	ludo
alberto	alberto
desegnita	desegnita
distas	distas
li	li
signo	signo
populara	populara
kredo	kredo
general	general
decembro	decembro
kongreso	kongreso
sep	sep
rivero	rivero
saint	saint
konsistas	konsistas
registrita	registrita
ferdinand	ferdinand
julius	julius
valo	valo
pioniro	pioniro
vi	vi
akademio	akademio
ligna	ligna
festivalo	festivalo
der	der
na	na
kresko	kresko
deklaris	deklaris
black	black
partikulare	partikulare
tu	tu
poemo	poemo
unika	unika
helpis	helpis
wien	wien
dekreto	dekreto
princo	princo
nuna	nuna
movado	movado
